peddle = জিনিসপত্র ফেরি করা; ফেরি করে বিক্রয়; 
steward = গোমস্তা; a person employed to manage another's property, especially a large house or estate
husband = হিসাবী পরিচালক; 
piercing = তীক্ষ্ন; ভেদক; মর্মস্পর্শ করা; 
pierce = রহস্যভেদ করা; গুপ্ত বিষয়ে প্রবেশ করা; প্রবেশ করান বা করা; ঢোকন বা ঢোকা; 
galleys =
slaughter = হত্যা; বধ; 
naught = শূন্য; কিছুই না; 
grief = বিষাদ; দুর্দশা; 
gore = জমাট বাঁধা রক্ত; 
steel = ইস্পাত; কঠিন করা; 
carnage = হত্যাকাণ্ড; ব্যাপক হত্যালীলা; 
anguish = যন্ত্রণা; বেদনা; ব্যথা; 
dialectical = ন্যায়শাস্ত্রসম্মত; relating to the logical discussion of ideas and opinions.
quixotic = বাস্তবজ্ঞানহীন; ভাববিলাসী; 
troupe = দল; 
torpid = মন্থর; জড়বুদ্ধি; মন্দগতি; 
lithe = ক্ষিপ্র; চটপটে; নমনীয়; কোমল; (especially of a person's body) thin, supple, and graceful.
retrospective = অতীত-সম্পর্কীয়; অতীতের ঘটনা-সম্পর্কিত; 
paean = বিজয়গাথা; 
philippic = কুত্সাপূর্ণ বক্তৃতা; তীব্রতাপূর্ণ নিন্দা; 
eulogy = প্রশংসা; প্রশংসাত্মক উক্তি; প্রশংসাপত্র; 
crescendo = সুরে তীব্রতার ক্রমবৃদ্বি; চড়া সুরে ত্তঠে এমনভাবে; ধাপে ধাপে চরম অবস্থার দিকে অগ্রগতি; 
hale = স্বাস্থ্যবান; সুস্থ; বলিষ্ঠ; 
lissome = নমনীয়; কোমল; 
loathsome = ঘৃণিত; জঘন্য; 
vigorous = সবল; তেজস্বী; 
olio = মিশ্রণ; বিভিন্ন দ্রব্যের সমবায়; 
melange = a mixture; a medley.
pilfering = অপহারী; অপহারক; steal (typically things of relatively little value). 
pilfer = ছিঁচকে চুরি করা; 
evasions = ছল; চাতুরী; কৌশলে পরিহার; 
bald = পালকহীন; নেড়া; রসকসহীন; মাধুর্যহীন; plain or blunt.
tacit = নীরব; ঊহ্য; 
overt = প্রত্যক্ষ ; প্রকাশ্য; প্রতীয়মান; খোলাখুলি; স্পষ্ট; 
rhetorical = বাগাড়ম্বরপূর্ণ; 
implicit = অন্তর্নিহিত; ঊহ্য; আভাসিত; 
lighthearted = দুশ্চিন্তামুক্ত; হাসিখুশি; 
lax = শিথিল; ঢিলা; 
priggish = অত্যন্ত যথার্থ্যপ্রিয়তা; 
impious = অধার্মিক; 
bootless = অনর্থক; বৃথা; জুতাহীন; 
indefatigable = অক্লান্ত; অধ্যবসায়ী; 
feckless = ব্যর্থ; নিস্তেজ; নিষ্প্রভ; অসহায়; 
preceded = অগ্রবর্তী হত্তয়া; 
homage = সম্মান; সশ্রদ্ধা স্বীকৃতি; আনুগত্য-স্বীকার; 
accrual = বৃদ্ধি; 
feasible = সম্ভাব্য; সাধ্য; সম্ভব; 
somber = নিরানন্দ; অন্ধকারাচ্ছন্ন; মলিন ত্ত বিষণ্ণ; 
philandering = পরকীয়া; ছিনলি করা; 
puckish = দুষ্টু; playful, especially in a mischievous way.
uninhibited = সংকোচমুক্ত; কুণ্ঠাহীন; 
prurient = কামুক; বিকৃত কামনা-পীড়িত; 
wry = বিকৃত; বাঁকা; 
dated = অপ্রচলিত; 
puritanical = গোঁড়া; অতিনৈষ্ঠিক; 
draconian = কাঠোর আইন-সংক্রান্ত; 
occupier = দখলকার; 
mercenaries = ভাড়াটে সৈনিক; ভাড়াটে বিদেশী সৈনিক; 
partisan = পক্ষাবলম্বী; পক্ষভুক্ত লোক; 
malicious = বিদ্বেষপরায়ণ; আক্রোশপূর্ণ; 
aggravated = কুপিত; প্রকোপিত; 
aggravate = উত্ত্যক্ত করা; তীব্রতর করা; 
flabbergasted = স্তম্ভিত; বিস্মিত; আশ্চর্যান্বিত; 
bedazzled = স্তম্ভিত হত্তয়া; অবাক্ হত্তয়া; আশ্চর্যান্বিত হত্তয়া; 
quagmire = কর্দমাক্ত জমি; জলাভূমি; 
fleeting = দ্রুতগামী; ক্ষণজীবী; 
expeditious = ত্বরিত; দ্রুত; তত্পর; 
swift = দ্রুতগতি; ত্বরিত; দ্রুত; 
icelanders = আইস্ল্যাণ্ডের অধিবাসী; 
revivification = পুনরূজ্জীবিত করা; পুনরুজ্জীবন; নবশক্তিসঞ্চার; 
rejuvenation = নবজীবন; পুনরুজ্জীবন; আয়ুবৃদ্ধি; 
wheat = গম; 
chaff = তুষ; ভুষি; 
triage = urgency ; assign degrees of urgency to (wounded or ill patients).
requite = প্রতিদান দেওয়া; প্রতিশোধ দেত্তয়া; 
accommodating = অমায়িক; উপকারপরায়ণ; সহজে মানিয়া লয় এমন; 
doggedly -> dogged = জিদি; 
idiosyncratically -> idiosyncratic = স্বকীয়; অদ্বিতীয়; মেজাজের বৈশিষ্ট্যগত; 
dismaying -> dismay = আতঙ্কে; আতঙ্কিত করা; 
confounding = বিভ্রান্তি; হতবুদ্ধি করা; বিস্মিত করা; 
gilding = সোনালী বার্নিশ; 
lilly = 
sneered = টিটকারি দেত্তয়া; টিটকারি; 
ostentatious = বড়াইপূর্ণ; ভানপূর্ণ; জাঁকালো; 
gauche = আনাড়ি; অবিবেচক; কৌশলশূন্য; 
irredentist = a person advocating the restoration to their country of any territory formerly belonging to it.
uncouth = অমার্জিত; সংস্কৃতিহীন; 
ludicrously -> ludicrous = হাস্যকর; 
lamentably = দুঃখজনকভাবে; 
waist = কোমর; জাহাজের মধ্যভাগ; 
deify = দেবতুল্য করা; 
distort = বিকৃত করা; 
dismal = অন্ধকারময়; বেদনাদায়ক; বিষণ্ণ; depressing; dreary.
pulchritude = beauty.
rapture = পরমানন্দ; নিবিড় আনন্দোচ্ছাস; 
ravishment = নারীধর্ষণ; কলাত্কার; 
upstanding = অকপট; খোলামেলা; স্পষ্টবাদী; 
corroborated = প্রতিপাদিত; 
corroborate = অনুমোদন করা; সমর্থন করা; প্রতিপাদন করা; সুনিশ্চিত করা; 
putative = জনসাধারণ্য পরিগণিত; generally considered or reputed to be.
conjectural = আনুমানিক; আন্দাজি; 
conjecture = অনুমান; আন্দাজ; 
assayed = বিশুদ্ধতা পরীক্ষা করা; 
irreconcilable = শত্রুভাবাপন্ন; 
oft = অনেকবার; বহুবার; প্রায়ই; ঘনঘন; 
fortitude = সহ্য; বীবত্বপূর্ণ সহিষ্ণুতা; মনোবল; 
adversity = বিদ্বেষ; বৈরভাব; শত্রুতা; দুর্দশা; প্রতিকূল; 
risibly -> risible = হাস্যপ্রবণ
credulous = বিশ্বাসপ্রবণ; 
purported = অতিরঞ্জিত; 
forgeries = জালিয়াতি; 
deluding = বিভ্রান্ত করা; প্রতারণা করা; 
apprising = অবগত করান; জ্ঞাপন করা; পরিচয় দেত্তয়া; inform or tell (someone).
depressing = বিষণ্ণ; বিষণ্ণ করে এমন; 
indicting = অভিযুক্ত করা; 
deception = প্রতারণা; ছলচাতুরি;
nemesis = অন্যায়ের প্রতিশোধ; পাপের উপযুক্ত শাস্তি; 
cunning = ধূর্ত; চতুরতা; 
wrongdoing = অপরাধ; অকাজ; 
etymologies = ব্যুৎপত্তি; শব্দতত্ত্ব; 
sober = সংযত; প্রশান্ত; গম্ভীর; 
sobriety = অপ্রমাদ; the state of being sober.
vivacious = প্রাণবন্ত; হাসিখুশি; 
lackluster = নিষ্প্রভ; দু্যতিহীন; 
mirthful = হাসিখুশি; আনন্দপূর্ণ; আমোদ প্রমদে উৎফুল্ল; 
preferential = পক্ষপাতমূলক; 
solemnity = গাম্ভীর্র্য; পরম গুরূত্ব; অনুষ্ঠান; the state or quality of being serious and dignified.
aghast = আতঙ্কগ্রস্ত; আতঙ্কে হতবুদ্ধি; ভীত; filled with horror or shock.
indiscretion = হঠকারিতা; অবিবেচনা; 
wane = হ্রাস পাত্তয়া; ক্ষয়; কমা; পতন; 
chastity = সতীত্ব; শুদ্ধতা; 
petty = ক্ষুদ্র; সামান্য; 
myrmidons = ভাড়াটিয়া গুণ্ডা; 
quacks = হাতুড়ে ডাক্তার; 
hectic = অস্থির; উত্তেজিত; 
stress = পীড়ন; কঠিন চাপ; 
unwinding = পেঁচ খোলা; পোক খুলিয়া যাত্তযা; গুটিয়ে রাখা জিনিস খোলা; 
unwind = গুটিয়ে রাখা জিনিস খোলা; undo or be undone after winding or being wound.
censorious = দোষদর্শী; ছিদ্রান্বেষী; ত্রুটিসন্ধানী; severely critical of others.
blithe = ফূর্তিবাজ; আমুদে; 
as though = যেন; 
fetid = দুর্গন্ধময়; পূতিগন্ধময়; smelling extremely unpleasant.
desiccated = শুষ্ক; শুকিয়ে নেওয়া; 
wizened = বিশীর্ণ; বিশুষ্ক; রোগা; 
arid = শুষ্ক; অনুর্বর; শুকনো; নীরস; 
hale = সুস্থ; স্বাস্থ্যবান; 
brunch = দুপুরের খাওয়া এবং প্রাতরাশের বদলে একবারই বেলা করে খাওযা; a late morning meal eaten instead of breakfast and lunch.
risible = হাস্যপ্রবণ; 
satirical = বিদ্রুপপূর্ণ; নিন্দাপূর্ণ;  
farcical = প্রহসনিক; হাস্যকর; 
labile = অস্থির; চঞ্চল; পরিবর্তনপ্রবণ; পরিবর্তনশীল; 
apologist = কৈফিয়তদানকারী; কোনো কিছুর পক্ষ সমর্থনকারী; 
sprint = পূর্ণবেগে দৌড়ান; 
gallivant = ছিনালি করা; ফ্লার্ট করা; 
tergiversate = পরস্পরবিরোধী উক্তি করা; 
traipse = ক্লান্তিকরভাবে হাঁটা; আলুখালু মহিলা; walk or move wearily or reluctantly.
digress = অবান্তর হত্তয়া; অপ্রাসঙ্গিক হত্তয়া; মূল বিষয় ছেড়ে বলা বা লেখা; 
equivocate = দ্ব্যর্থবাক্য ব্যবহার করা; বাক্চাতুরী করা; 
astute = বিচক্ষণ; কৌশলী; তীক্ষ্ণবুদ্ধি; 
vociferous = উচ্চ চিতকার করে এমন; 
drum up = 
retrospective = অতীত-সম্পর্কীয়; অতীতের ঘটনা-সম্পর্কিত; ভূতাপেক্ষ; 
sere = শুষ্ক ত্ত বিশীর্ণ; 
passe = বিগতযৌবনা; শ্রেষ্ঠ সময় অতিক্রম করিয়াছে এমন; no longer fashionable; out of date.
peppery = ঝাল; রাগী; ক্রুদ্ধ; 
defiled = কলুষিত; 
defile = অপরিচ্ছন্ন করা; কলুষিত করা; নোংরা করা; 
wallowing = ফুলিয়া উঠা; তরঙ্গায়িত হইয়া ত্তঠা; 
stoic = নির্বিকার; 
bogged down = 
resplendent = প্রভাময়; প্রোজ্জ্বল; ঝকঝকে; 
mired = পাঁকে আটকান; পাঁকে আটকে যাওয়া; cause to become stuck in mud.
naysayer = 
volleys = নিক্ষেপ করা; বরখাস্ত করা; মুক্ত করা; খালাস; 
razed -> raze = সম্পূর্ণ ধ্বংস করা; বিনষ্ট করা; 
eerie = ভুতুড়ে; ভয়ানক; ভয় জাগায় এমন; অতিপ্রাকৃত; strange and frightening.
stillness = নীরবতা; স্তব্ধতা; 
flouting = অবজ্ঞা করা; বিদ্রুপ করা; 
assaying =  বিশুদ্ধতা পরীক্ষা করা; 
teeming = পরিপূর্ণ; 
stewing = ভাপে সিদ্ধ হত্তয়া; ভাপে সিদ্ধ করা; 
abounding = প্রাচুর্যপূর্ণ; সমৃদ্ধ; উচ্ছ্বাসিত; 
obviated = কৌশলে পরিহার করা; পরিহার করা; 
relegating = নির্বাসিত করা; নিম্নপদে সরান; consign or dismiss to an inferior rank or position.
bystander = দর্শক; নিরীক্ষক; 
curtailing = হ্রাস করা; খর্ব করা; কমান; সঙ্কুচিত করা; 
undermining = ধ্বংসসাধনের চেষ্টা করা; গোপনে ক্ষতিসাধন করা; 
lobbying = তদবির; 
instigating = প্ররোচক; 
facilitating = সহজতর করা; সুবিধা; make (an action or process) easy or easier.
pathogen = রোগজনক শক্তি; a bacterium, virus, or other microorganism that can cause disease.
render = পারিশ্রমিক প্রদান করা; পারিশ্রমিক; পরিণত করা; প্রতিদানে দেওয়া; 
lethal = মারাত্মক; প্রাণঘাতী; 
contraband = নিষিদ্ধ; বেআইনী; 
surplus = উদ্বৃত্ত; অতিরিক্ত; 
aurora = ঊষা; 
pantheon = সর্বদেবতার মন্দির; all the gods of a people or religion collectively.
plethora = আধিক্য; 
predominantly = প্রধানত; 
cosseted = আদর করা; 
smattering = ভাসা-ভাসা জ্ঞান; পল্লবগ্রাহী; 
abodes = ঘর-বাড়ী; গৃহ; ঘর; 
opulent = ঐশ্বর্যশালী; সমৃদ্ধিশালী; ধনবান; 
boast = অহংকার করা; বড়াই করা; দম্ভভরে কথা কহা; 
Gilded age = সোনালী যুগ; 
ramshackle = জীর্ণ; ভগ্নপ্রায়; 
contiguous = সংলগ্ন; নিকটস্থ; পার্শ্ববর্তী; 
garlanded = ফুলের মালা; মনোরমভাবে লিখিত; চিত্তবিনোদনকর; 
underestimated -> underestimate = অবমূল্যায়ন করা
dilapidated = জীর্ণ; ক্ষয়প্রাপ্ত; ধ্বংসপ্রাপ্ত; 
antiquated = অপ্রচলিত; সেকেল; মান্ধাতার আমলের; 
rifle = রাইফেল; বন্দুক; 
forded = হাঁটিয়া পার হত্তয়া; 
ford = হাঁটুজল; হাঁটিয়া পার হত্তয়া; নদীর যে অগভীর অংশ ঐরূপে পার হওয়া; 
canyon = গভীর খাদ; গভীর গিরিখাত; 
wended = পথ চলা; 
rapscallion = পাজী লোক; বদমাশ; ইতর লোক; a mischievous person.
defector = দলত্যাগী; 
deity = দেবতা; 
devotee = ভক্ত; অনুরক্ত সেবক; 
impasse = অচল অবস্থা; কোণঠাসা অবস্থা; চরম সংকট; 
pause = থামা; বিরতি; 
timeout = বিরতি; সময় শেষ; 
confrontation = মুকাবিলা; রুখে দাঁড়ানো; 
stalemate = অচল অবস্থা; 
agony = নিদারূণ যন্ত্রণা; 
painstaking = কষ্টসহিষ্ণু; শ্রমসাদ্য; 
tortuous = কুটিল; অসরল; 
excruciating = মর্মযন্ত্রণাপূর্ণ; অতি যন্ত্রণাদায়ক; 
torturous -> torture = যন্ত্রণা; যন্ত্রণা দেত্তয়া; নিপীড়ন; 
detractor = নিন্দুক; অপবাদকারী; 
champion = রক্ষক; সমর্থন করা; 
gadfly = দংশ; a fly that bites livestock, especially a horsefly, warble fly, or botfly.
chump = বোকা লোক; মাথামোটা; 
forte = কারো বিশেষ দক্ষতা বা পটুতা; 
deficiency = অভাব; স্বল্পতা; কমতি; ত্রুটি; অসম্পূর্ণতা; 
devout = ধর্মপ্রাণ; ধার্মিক; ভক্ত; 
exotic = বহিরাগত; বিদেশী; 
esoteric = গূঢ়; আভ্যন্তরীণ; লুক্কায়িত; গুপ্ত; 
acculturation = সাংস্কৃতিক অভিযোজন; 
assimilation = আত্তীকরণ; আয়ত্তকরণ; আত্মীকরণ; 
investiture = সজ্জীকরণ; বিভূষণ; অভিষেক; the action of formally investing a person with honors or rank. 
indebtedness = দায়; বাধ্যবাধকতা; 
estrangement = বিরহ; বিচ্ছেদ; ছাড়াছাড়ি; 
satire = বিদ্রুপ; ব্যঙ্গধর্মী রচনা; 
caricature = ব্যঙ্গচিত্র; 
pretended = কৃত্রিম; 
sarcastic = তীব্র ব্যঙ্গপূর্ণ; 
specious = আচমকা-সুন্দর; ভালো; superficially plausible, but actually wrong.
spurious = কৃত্রিম; ভেজাল; মিথ্যা; 
squalid = দারিদ্র্যপীড়িত; 
stolid = অবিচলিত; আবেগ-রহিত; 
stoic = নির্বিকার; 
jurors = জুরি; নির্ণায়ক-সভ্য; 
furnish = সজ্জিত করা; সরবরাহ করা; 
delineate = বর্ণনা করা; চিত্রিত করা; 
outlaw = নির্বাসিত; বিতাড়িত করা; বহিষ্কৃত করা; 
stipulate = চুক্তির শর্ত করা; উপপত্রিক; demand or specify (a requirement), typically as part of a bargain or agreement.
effectual = সফল; 
flagitious = কলুষিত; গর্হিত; 
boorish = বর্বর; অভদ্র; গেঁয়ো;
heinous = জঘন্য; চরম অসত বা দূর্বৃত্তিপূর্ণ; 
pretend = সাজা; মিথ্যা বর্ণনা জাহির করা; 
disaffection = অনাত্মীয়; স্নেহশূন্য; আনুরাগশুন্য; 
torpid = মন্থর; অবশ; জড়বুদ্ধি; mentally or physically inactive; lethargic.




tepid = ঈষৎ উষ্ণ; কুসুম কুসুম গরম; 
sedulous = পরিশ্রমী; অধ্যবসায়ী; 
inkling = আভাস; ইঙ্গিত; 
shrewd = বিচক্ষণ; বিচক্ষণ; 
penetrating = তীক্ষ্ন; সূক্ষ্মবুদ্ধি; তীক্ষ্নবুদ্ধি; তীক্ষ্ণ ও গভীর অন্তর্দৃষ্টিসম্পন্ন; 
inchoate = অপরিণত; অনতিস্ফুত; 
sinuous = সর্পিল; আঁকাবাঁকা; পেঁচাল; 
dialectical = ন্যায়শাস্ত্রসম্মত; মতামত, ধারণা ইত্যাদির সত্যতা অনুসন্ধান সংক্রান্ত; 
full-bore = at full speed or maximum capacity.
high-handedly = স্বচ্ছন্দভাবে;  
impeccably -> impeccable = নিখুঁত; অনবদ্য; ত্রুটিহীন; নির্দোষ; অনপরাধ; 
wholly = বিলকুল; সম্পূর্ণরূপে; 
callous = অনুভূতিহীন; নির্মম; নির্বিকার; 
contrite = অনুতপ্ত; 
penitential = অনুতাপসংক্রান্ত; প্রায়শ্চিত্তসংক্রান্ত; 
messianic = মশীহ; of or relating to the Messiah.
messiah = যীশুখ্রীষ্ট; অত্যাচারিত জাতির বা দেশের মুক্তিদাতা; 
ebb = ভাটা; মন্দা; হ্রাস; 
metabolize = বিপাক করা বা হওয়া; 
satiate = সম্পূর্ণ পরিতৃপ্ত করা; 
blandishments = চাটুবাক্য; খোশামোদ; 
con artist = a person who cheats or tricks others by persuading them to believe something that is not true.
swamp = জলাভূমি; প্লাবিত করা; অভিভূত করা; 
irascible = একরোখা;  
leery = ধূর্ত; সতর্ক; 
supine = কুঁড়ে; অলস; 
implacable = নির্দয়; ক্ষমাহীন; 
mongers = বিক্রেতা; ব্যবসায়ী; 
demise = মৃতু্য; মরণ; জীবনহানি;  
apocalyptic = রহস্যদঘাটন; রহস্যদঘাটন-সংক্রান্ত; 
spurious = কৃত্রিম; ভেজাল; জাল-করা; মিথ্যা; 
saccharine = অসহ্যরকম মিষ্ট; চিনির মত; শর্করাপূর্ণ; 
agitprop = political (originally communist) propaganda, especially in art or literature.
virtuous = ধার্মিক; নিষ্পাপ; 
contemptible = ঘৃণ্য; নীচ; নিকৃষ্ট; 
faddish -> faddist = খেয়ালী ব্যক্তি
sophisticated = বাস্তববুদ্ধিসম্পন্ন; অবিশুদ্ধ; অপ্রকৃত; 
scurvy = ঘৃণ্য; নীচ; জঘন্য; 
evinced = স্পষ্ট করিয়া দেখান; স্পষ্ট প্রদর্শন করা;  
slouching = stand, move, or sit in a lazy, drooping way. 
cavalier = দাম্ভিক; রূক্ষ; শিষ্টাচারবর্জিত; 
lax = শিথিল; ঢিলা; অসংযত; অমনোযোগী; 
aristocratic = সম্ভ্রান্ত; অভিজাত; 
barbarous = বর্বর; অসভ্য; 
slack = ঢিলা; মন্থর; শিথিল; v. অবহেলা করা; হ্রাস পাত্তয়া; 
sap = প্রাণরস; প্রাণশক্তি; 
dupe = প্রতারিত ব্যক্তি; প্রতারণা করা; 
quack = হাতুড়ে ডাক্তার; 
shyster = মতলবাজ উকিল; 
infamy = অখ্যাতি; কুখ্যাতি; 
lounge = আরামকক্ষ; আলস্যে কাল কাটানো; 
bask = পোহানো; আগুন বা রোদ পোহানো; উপভোগ করা; পোয়ানো; 
lurk = লুকিয়ে থাকা; ওৎ পেতে থাকা; প্রতীক্ষায় থাকা; 
dally = গড়িমসি করা; টালবাহানা করা; সময় নষ্ট করা; 
tarry = গড়িমসি করা; বিলম্ব করা; 
skulk = ভীরুতাবশত অথবা কাজ থেকে সরে পড়া; কাজ এড়ান; 
legion = বিরাট সংখ্যা; বিপুল সংখ্যা; সৈন্যবাহিনী; 
similes = উপমা; রুপক; 
appellation = খেতাব; উপাধি; 
sobriquet = উপনাম; কল্পিত নাম; 
misnomer = অসার্থক নাম; অপ্রকৃত নাম; মিথ্যা নাম; 
neologism = নূতন শব্দ; নূতন মত; নূতন অর্থে পুরাতন শব্দপ্রয়োগ; 
aliases -> alias = ওরফে;  উপনাম; ছদ্মনাম; 
warfare = যুদ্ধবিগ্রহ;  
pastor = যাজক; ধর্মোপদেষ্টা; 
blanket = কম্বল; adj. সাধারণ; সার্বজনীন; v. কম্বল দিয়া ঢাকা
exterminated = নির্মূল;
exterminate = উপড়াইয়া ফেলা; নির্মূল করা; ধ্বংস করা; সম্পূর্ণ ধ্বংস করা; 
pandemic = পৃথিবীব্যাপি; 
homogeneous = সজাতি; একরূপ; সমশ্রেণীভুক্ত; 
indigenous = দেশীয়; স্বদেশজাত; দেশজ; 
ecumenical = সর্বজনীন; 
indignant = অকৃতজ্ঞতা; রুষ্ট; 
content = সন্তুষ্ট; তৃপ্ত; বিষয়বস্তু; 
fiery = অগ্নিসদৃশ; জ্বলন্ত; অগ্নিময়; 
extemporaneous = তত্ক্ষণিক; পূর্বপ্রস্তুতিহীন; 
lubricious = লম্পট; কামী; তৈলাক্ত; পিচ্ছিল; মসৃণ; 
impromptu = উপস্থিতমত; তাৎক্ষণিক; পূর্বপ্রস্তুতি ব্যতীত; 
premeditated = পূর্বকল্পিত; 
implore = সনির্বন্ধ অনুরোধ করা; মিনতি করা; 
carnage = হত্যাকাণ্ড; ব্যাপক হত্যালীলা; 
implored = অনুরূদ্ধ; beg someone earnestly or desperately to do something.
torpedoes = নিষ্ক্রিয় করা; অচল করা; 
divagate = দিপথে যাত্তয়া; বিষয়চ্যুত হওয়া;
wail = দু:খ প্রকাশ করা; ক্রঁদন; উচ্চ কণ্ঠে ক্রন্দন; 
restitution = ক্ষতিপূরণ; প্রতিদান; 
abjured = শপথপূর্বক পরিত্যাগ করা; 
jeopardized = বিপন্ন; বিপদ্গ্রস্ত করা; ঝুঁকিগ্রহণ করা; 
reneged = পরিত্যাগ করা; প্রতিজ্ঞা ভঙ্গ করা; 
deposed = পদচ্যুত; পদচু্যত করা; 
censured = অনুযু়ক্ত; express severe disapproval of (someone or something), typically in a formal statement.
forwent = ত্যাগ করা; ভোগ ত্যাগ করা; পরিহার করিয়া চলা; 
remark = মন্তব্য; বক্তব্য; 
compliment = প্রশংসা করা; অভিনঁদন জানান; a polite expression of praise or admiration.
slight = অল্প; সামান্য; অসম্মান; অমর্যাদা করা; হেলাফেলা; 
gibe = উপহাস; অবজ্ঞা; ঘৃণা; 
profundity = অসামান্যতা; deep insight; great depth of knowledge or thought.
panegyric = প্রশংসাপূর্ণ; 
maxim = সুপ্রতিষ্ঠিত বাক্য; 
meddling = অনধিকারচর্চা; পরচর্চা; 
expenditure = ব্যয়; খরচ; 
ubiquity = সর্বব্যাপিতা; বিশ্বব্যাপিত্ব; 
omnipresence = সর্বত্র বিদ্যমানতা; 
tacit = নীরব; মৌন; ঊহ্য; অকথিত; 
implicit = অন্তর্নিহিত; ঊহ্য; গূঢ়; 
opined = মতপ্রকাশ করা; hold and state as one's opinion.
pun = শ্লেষ; শ্লেষালঙ্কার; দ্ব্যর্থক শব্দপ্রয়োগ; 
intrinsic = স্বকীয়; সহজাত; অপরিহার্য; belonging naturally; essential.
extraneous = বিদেশী; বহি:স্থ; অপ্রাসঙ্গিক; 
peripheral = সীমান্তবর্তী; প্রান্তস্থ; 
enraged = ক্রুদ্ধ; রূষ্ট; প্রকোপিত; 
smitten = প্রহৃত; strike with a firm blow.
incensed = প্রকুপিত; very angry; enraged.
fulminate = বিস্ফোরিত হত্তয়া; নিন্দা ঘোষণা করা; express vehement protest.
chicanery = ছলচাতুরি; প্রতারণা;  
specious = আপাত সত্য হলেও আসলে তা মিথ্যা; superficially plausible, but actually wrong.
sweeping = সুদূরপ্রসারিত; সুদূরপ্রসারী; wide in range or effect.
meretricious = জাঁকাল; চটকদার; মিথ্যা আড়ম্বর দ্বারা আকর্ষণ করে এমন; 
acclaim = জয়ধ্বনি; উচ্চ প্রশংসাধ্বনি; অভিনন্দিত করা; 
opprobrium = নিন্দা; অপমান; 
fulmination = an expression of vehement protest.
approbation = সম্মতি; অনুমোদন; 
plaudits = তারিফ; প্রশংসা; 
exculpate = দোষক্ষালন করা; 
liberate = মুক্ত করা; স্বাধীন করা; মুক্তি দেওয়া; 
inter = আন্তঃ; সমাহিত করা; 
excuse = ছুতা; ক্ষমা করা; 
manumit = দাসত্ব হইতে মুক্ত করা; ছাড়িয়া দেওয়া; 
vindicate = সত্যতা প্রতিপাদন করা; 
aggrieved -> aggrieve =  অসন্তুষ্ট করা; অত্যাচার করা; ব্যথিত করা; অন্যায় আচরণ করা; দু:খ দেত্তয়া; অসন্তুষ্ট করা; 
beguiled = প্রতারিত; 
enamored = প্রেমমুগ্ধ; প্রসক্ত;
enamor = মোহিত করা; মুগ্ধ করা; প্রেমোচ্ছন্ন করা;  
obsessed = অন্ধকারাচ্ছন্ন; 
obsess = প্রভাবিত করা; আবিষ্ট করা; 
vexed = উত্ত্যক্ত; জালাতন; বিরক্তি; 
vex = উত্ত্যক্ত করা; জালাতন করা; 
possessed = অধিকৃত; আবিষ্ট; অধিকারী; 
possess = অধিকার করা; ভোগদখল করা; শাসন করা; মালিক হত্তয়া; 
turmoil = অশান্তি; টালমাটাল; বিক্ষোভ; হাঙ্গামা; 
esteem = শ্রদ্ধা; সম্মান; 
tribulation = দুর্দশা; দারুণ ক্লেশ; কঠোর যন্ত্রণা; 
conviction = বিশ্বাস; প্রত্যয়; দৃঢ় বিশ্বাস; অপরাধী সাব্যস্ত হওয়া; দণ্ডাদেশ; 
self-esteem = আত্মসম্মান; আত্মসম্মান; 
pride = গর্ব; অহংকার; 
equanimity = মনের স্থিরতা; মনের ধীরতা; মেজাজের ধীরতা; কামাবশায়িতা; 
denomination = আখ্যা; আখ্যাপ্রদান; নামপ্রদান; ওজন, দৈর্ঘ্য, মূল্য ইত্যাদি নির্দেশক একক
sangfroid = কামাবশায়িতা; composure or coolness, sometimes excessive, as shown in danger or under trying circumstances.
incipient = প্রাথমিক; প্রারম্ভিক; জায়মান; in an initial stage; beginning to happen or develop.
disorganized = বিশৃঙ্খল; 
nascent = বর্ধনশীল; জন্মলাভ করিতেছে এমন; জায়মান; 
nebulous = আবছা; অস্পষ্ট; কুয়াসাচ্ছন্ন; 
inconsequential = তুচ্ছ; অবান্তর; যুক্তিধারাহীন; 
condoned = মকুব করা; ক্ষমা করা; accept and allow (behavior that is considered morally wrong or offensive) to continue.
pardoned = ক্ষমা করা; মার্জনা করা; অব্যাহতি দেত্তয়া; 
sabotaged = অন্তর্ঘাত করা; নাশকতা; যুদ্ধ; অন্তর্ঘাত করা; 
clamor = গোলমাল; বিক্ষোভ; 
rabble = জনতা; ভিড়; a disorderly crowd; a mob.
din = কানে তালা লাগান; হট্টগোল; একটানা উচ্চ শব্দ; 




artless = সরল; অপটু; ছলনাবিহীন; 
shrewd = বিচক্ষণ; তীক্ষ্ন; 
ingenuous = মনখোলা; সাদাসিধে; 
klutzy = clumsy, awkward, or foolish.
adroit = দক্ষ; নিপুণ; কুশলী; 
artful = চতুর; কৌশলী; ছলনাময়; clever or skillful, typically in a crafty or cunning way.
atrocious = নৃশংস; অত্যন্ত নিষ্ঠুর; খুব খারাপ; 
trite = মামুলি; গতানুগতিক; 
witty = রসিক ও বুদ্ধিমান; 
underpin = সমর্থন করা; জোরালো করা; 
irradiates = উদ্ভাসিত করা; আলোকিত করা; কিরণবর্ষণ করা; 
underserves -> underserved = রঞ্চিত; inadequately provided with a service or facility.
overwhelm = অভিভূত করা; সম্পূর্ণরূপে নিমজ্জিত করা; ভাসিয়ে দেওয়া; ছেয়ে ফেলা; 
undergird = secure or fasten from the underside, especially by a rope or chain passed underneath. provide support or a firm basis for.
saturate = পরিপূর্ণ করা; 
cleave = বিদীর্ণ করা; বিভক্ত করা; ভেঙে ফেলা; খণ্ডিত করা; 
torment = নির্যাতন করা; যন্ত্রণা দেওয়া; যন্ত্রণা;
wallop = আচ্ছামত প্রহার করা; 
interring = সমাহিত করা; পুঁতা; 
annihilation = নাশ; ধ্বংস; 
palliating = উপশম করা; প্রশমিত করা; ক্ষমা করা; 
compounding = মিশ্রণ; 
assuaging = প্রশমিত করা; শান্ত করা; উপশম করা; 
dejected = মনমরা; বিষণ্ন; 
curt = চাঁচাছোলা; সংক্ষিপ্ত; rudely brief.
mute = বোবা; অনুচ্চারিত; 
luridness -> lurid = উত্তেজনাপূর্ণ; চাঞ্চল্যকর; উৎকট; বিকট; 
sagacity = বিচক্ষণতা; বিজ্ঞতা; 
prowess = প্রতাপ; পরাক্রম; 
limpidity = স্পষ্টতা; স্বচ্ছতা; 
implicated = জড়ানো; সংশ্লিষ্ট করা; অর্থপ্রকাশ করা; 
pleased = খুশি; তৃপ্ত; আনন্দিত; পরিতুষ্ট; 
spree = মাতলামি; 
melancholy = মনমরা; হতাশ; ভগ্নহৃদয়; 
wondering = বিস্মিত হত্তয়া; 
fabulous = কল্পিত; চমত্কার; 
Proust = প্রুস্তের;
fantastical = চমত্কার; কল্পনাপ্রসূত; উদ্ভট;  
bombastic = শব্দাড়ম্বরপূর্ণ; অত্যধিক জমকালো; 
belletristic = literature regarded as a fine art, especially as having a purely aesthetic function.
gist = সারকথা; মূল বক্তব্য; সারমর্ম; 
genesis = সূচনা; জনন; সৃষ্টি; জন্ম; 
concatenate = একসঙ্গে জোড়া; শ্রেণীবদ্ধভাবে সংযুক্ত করা; 
indemnify = নিরাপদ্ করা; ক্ষতিপূরণ করা; ভবিষ্যৎ ক্ষয়ক্ষতি পূরণের নিশ্চয়তা দেওয়া; 
aggression = আক্রমণ; আগ্রাসন; বিবাদের সূত্রপাত; আক্রমনাত্নক; 
overt = প্রকাশ্য; প্রত্যক্ষ; স্পষ্ট; খোলাখুলি; 
resolutely = অটলভাবে; 
hankering = তীব্র লালসা; 
proclivity = ঝোঁক; স্বাভাবিক প্রবণতা; 
implacability = ক্ষমাহীনতা; 
joviality = আনন্দিতা; প্রফুল্লতা; 
congruent = সর্বসম; অনুরূপ; উপযোগী; ঐক্যবিশিষ্ট; সংগতিপূর্ণ; 
unbridled = লাগামহীন; অসংযত; 
rage = ক্রোধ; ক্ষিপ্ততা; 
ardor = আকুলতা; আকুতি; enthusiasm or passion.
sorrow = দুঃখ; শোক; 
rue = অনুতাপ; দু:খ; অনুশোচনা করা; 
affinity = সম্বন্ধ; কুটম্বিতা; 
remorse = অনুশোচনা; অনুতাপ; 
piecemeal = খণ্ডে খণ্ডে; টুকরা টুকরাভাবে; একর্টু একটু করিয়া; 
voluble = বাক্পটু; অনর্গল বক্তৃতা দিতে পারে এমন; 
exhaustive = সম্পূর্ণ; সমগ্র; 
compendious = সংক্ষিপ্ত; ক্ষুদ্র; 
commanding = আদেশসূচক; শাসনক্ষমতা-সম্পন্ন; 
ascension = আরোহণ; উত্তরণ; অভিক্রমণ; সিংহাসনে আরোহণ; 
austere = উগ্র; কঠোর; 
daunted = ভীত করা; দমন করা; 
diligence = অধ্যবসায়; পরিশ্রম; 
asperity = বন্ধুরতা; কঠোরতা; 
inscrutability = অবর্ণনীয়তা; দুর্বোধ্যতা; 
rigor = কঠোরতা; কাঠিন্য; যথাযথতা; কড়াকড়ি; 
tethered = দড়ি দ্বারা আবদ্ধ; 
tether = দড়িতে বাঁধিয়া আটকাইয়া রাখা; শিকল; 
extirpated -> extirpate = সম্পূর্ণ ধ্বংস করা; নির্মূল করা; 
extricate = মুক্ত করা; উদ্ধার করা; 
interred = প্রোথিত; place (a corpse) in a grave or tomb, typically with funeral rites. 
effaced = মুছিয়া ফেলা; ঘসিয়া তুলিয়া ফেলা;  উপরিভাগ নষ্ট করা; 
hallowed = পবিত্র; ভক্তি করা; 
escalating = ধাপে ধাপে বৃদ্ধি করা; একটু একটু করে বৃদ্ধি পাওয়া; 
jeer = ব্যঙ্গ করা; বিদ্রূপ করা
bleacher = যে ব্যক্তি সাদা করে; a person or thing that bleaches.
debacle = ছত্রভঙ্গ; সম্পূর্ণ পতন; সম্পূর্ণ পরাজয়; ধ্বংস;
rout = ছত্রভঙ্গ; সম্পূর্ণ পরাজিত করা; হৈচৈপূর্ণ ভিড়; 
boondoggle = waste money or time on unnecessary or questionable projects.
forgery = জালিয়াতি; 
fallacy = প্রতারণামূলক কিছু; a mistaken belief, especially one based on unsound argument.
infirmity = দুর্বলতা; স্থবিরতা; 
incumbent = অবশ্যপালনীয়; আরোপিত; 
stint = সংযমন; নিয়ন্ত্রণ; 
consented = সম্মত; অনুমোদিত; 
mustered up = জড়ো করা; 
mustered  = জড় করা; তালিকাভুক্ত করা; সমবেত; 
fielded = 
reneged = পরিত্যাগ করা; ফিরাইয়া লত্তয়া; প্রতিজ্ঞা ভঙ্গ করা; 
honed -> hone = শান-পাথার ঘসিয়া ধার দেত্তয়া; sharpen (a blade).
abrogated = বাতিল করা; রহিত করা;
insurmountable = অদমনীয়; অনতিক্রমণীয়; অলঙ্ঘ্য; 
pale = ম্লান; বিবর্ণ; ফেকাশে; 
rift = ফুটা; চিড়; ফাটল; ফুটা; 
breach = ভঙ্গ; লঙ্ঘন; ফাটল তৈরি করা; 
piety = ভক্তি; ধার্মিকতা; ধর্মানুরাগ; 
befitting = যুগোপযোগী; 
idyllic = সরল শান্ত ত্ত মনোরম; extremely happy, peaceful, or picturesque.
patrimonial = পৈতৃক সম্পত্তিসংক্রান্ত; বংশগত; 
discern = উপলব্ধি করা; নির্ধারিত করা; ঠিক করা; perceive or recognize (something).
tenacity = জিদ; the quality or fact of being able to grip something firmly; grip.
perspicacity = স্বচ্ছদৃষ্টিসম্পন্নতা; 
precocity = অকালপক্কতা; পাকনামী; 
improbity = অসাধুতা; বদমাশি; 
urbanity = ভদ্রতা; মার্জিত ব্যবহার; শহুরে প্রভাব; সৌজন্য; 
dazzling = উজ্জ্বল; চক্চকে; দীপ্তিমান্; 
tarnished = কলঙ্কিত;  
torrid = উষ্ণ; very hot and dry.
translucence = আংশিক স্বচ্ছতা; নির্মলতা; 
evanescence = অদৃশ্যতা; বিলোপন; বিলোপ; 
refulgence = উজ্জ্বল দীপ্তি; প্রভা; দ্যুতি; 
tumescence = স্ফীত হইয়া উঠিতেছে এমন অবস্থা; 
radiance = প্রভা; ঔজ্জ্বল্য; দীপ্তি; রশ্মি বিকিরণ; 
sussing = realize; grasp.
pretension = ভণ্ডামি; ন্যায্য দাবি; 
surpassed = অতিক্রান্ত; 
mordant = তীব্র; মর্মভেদী; 
jurisprudent = আইন বিষয়ক দক্ষতা; relating to the theory or philosophy of law.
trenchant = তীক্ষ্ন; তীব্র; মর্মভেদী; 
self-abasement = আত্মা-অবমাননা; নিজে কে ছোটো করা; 
inmate = নিবাসী; বাসিন্দা; 
probation = শিক্ষানবিস; সত্যতা-প্রমাণীকরণ; 
beseeched = সাগ্রহে প্রার্থনা করা; মিনতি করা; 
chided = ভর্ত্সনা করা; তিরস্কার করা; 
snubbed = তিরস্কার করা; ধমক দেত্তয়া; 
conceded = স্বীকার করা; 
drummed = ঢাক বাজান; 
supplicated = মিনতিপূর্ন আবেদন করা; অনুনয়-বিনয় করা; ask or beg for something earnestly or humbly.
verged = সীমাস্থ হত্তয়া; verge = কিনারা; সীমানা; 
obsessive = অত্যধিক; আচ্ছন্নকারী; বিমুগ্ধকারী; 
lay down = পরিত্যাগ করা; ছাড়িয়া দেত্তয়া; 
willing = রাজী; সম্মত; ইচ্ছুক; 
fanatical = ধর্মান্ধ; অতিশয় অনুরক্ত; গোঁড়ামিপূর্ণ; অতিশয় গোঁড়া; 
fickle = চপল; পরিবর্তনশীল; 
mortifying = বিরক্তিকর; যন্ত্রণাদায়ক; অপমানজনক; cause to feel embarrassed, ashamed, or humiliated.
zealous = প্রবল উদ্দীপনাপূর্ণ; গভীর অনুভূতিপূর্ণ; প্রবল আগ্রহপূর্ণ; 
indeterminate = অনির্ণীত; অপরিচ্ছিন্ন; 
sumptuous = অতীব ব্যয়বহুল; ঐশ্বর্যবান; 
deposed = পদচ্যুত; 
pernicious = ক্ষতিকর; সর্বনাশা; 
reactionary = প্রতিক্রিয়াশীল; 
venerable = শ্রদ্ধেয়; প্রবীণ; গুরু; 
epicurean = প্রমোদপ্রিয়; বিলাসপ্রিয়; রূচিবাগীশ; দৈহিক সুখভোগী; 
grievous = দু:খজনক; মর্মান্তিক; পীড়াদায়ক; কষ্টকর; 
baneful = বিষাক্ত; ধ্বংসক; সর্বনাশা; মারাত্মক ক্ষতিকর; 
fastidious = খুঁতখুঁতে; রূচিবাগীশ; 
mayhem = মারপিট; হাতাহাতি; দাঙ্গাহাঙ্গামার অবস্থা; 
autonomy = স্বায়ত্তশাসন; 
dominance = কর্তৃত্ব; প্রভাব; 
millionth = দশলক্ষ ভাগের এক ভাগ; 
quark = তত্ত্ব-অনুমিত একধরণের অতি ক্ষুদ্র মৌল কণা; 
infinitesimal = ক্ষুদ্রাতিক্ষুদ্র; অতি ক্ষুদ্র; 
fleeting = দ্রুতগামী; ক্ষণজীবী; 
solitary = নির্জন; একাকী; 
synergetic =  working together; সমন্বিত; সম্মিলিত; 
exegetic = ব্যাখ্যামূলক; 
unilateral = একতরফা; একপার্শ্বিক; 
collusive = অশুভ আঁতাতে বদ্ধ; 
bile = anger; irritability. পিত্ত; পলাগ্নি; 
marrow = মজ্জা; সারাংশ; 
claptrap = ফাঁকা চটকদার কথা; প্রশংসালাভের ফন্দি; absurd or nonsensical talk or ideas.
fettle = খোসমেজাজে; অবস্থা; 
dross = আবর্জনা; 
retort = প্রতিশোধ; চতুর উত্তর দেত্তয়া; সমুচিত জবাব;
rejoinder = প্রতিউত্তর; সমুচিত জবাব; প্রতিবাদ; 
procrastination = গড়িমসি; ঢিমেতেতালা; দীর্ঘসূত্রতা; 
sorcerer = মায়াবী; যাদুকর; a person who claims or is believed to have magic powers; a wizard.
